*% SEIKO EPSON ESC/POS Printer Driver Module Description File
*% Copyright 2011 SEIKO EPSON corp. 
*% All Rights Reserved. 
*% Permission is granted for redistribution of this file as
*% long as this copyright notice is intact and the contents
*% of the file is not altered in any way from its original form.
*% End of Copyright statement

[User Mode Printer Driver Information]

UserIFModule=EAPuif7.DLL
UIResourceModule=EAPuir0.DLL
UILanguageConfigFile=EAPLangSetting.INI

ResourceModule=EAPr917e.DLL
SplResourceModule=EAPr917e.DLL

MainModule=EAPjnl7.DLL

ImageBarcodeLibrary=EAPBcd0.DLL
ImageBarcodeRLibrary=EAPBcdR0.DLL
UMRStandardModule=EAPurn0.DLL
UMRIMMDMonoModule=EAPurc0.DLL
IMMDMonoModule=EAPimc0.DLL
OutputMonoModuleI=EAPdpc0.DLL
UMRIMMDModule=EAPurc0.DLL
IMMDModule=EAPimc0.DLL
OutputModuleI=EAPdpc0.DLL
DispMsgModule=EAPdmsg0.EXE
HalftoneModule1bpp=EAPHT1BP.DLL
HalftoneModule4bpp=EAPHT4BP.DLL
UnicodeConversionConfigFile=TM-T86FII_ank.txt

HelpFile=EAPhlp0.CHM


CtrlAEditor=EAPCTLED.EXE
LogSetTool=%PROGRAMFILES%\EPSON\EPSON Advanced Printer Driver 4\EAPLogSetup.exe
UnicodeConversionDLL=%PROGRAMFILES%\EPSON\EPSON Advanced Printer Driver 4\Tools\UnicodeModule\EpsUCCvt.dll
CommonLogoTool=%PROGRAMFILES%\EPSON\TMFLogoUtl\TMFLOGOUTL.EXE
ModelName=TM-T86FII,98
